WWWWWWWWWWWWWWWWWWWWWW
W.WW        W W      W
W    WWWWWW W WWWWWW W
WWWWWW     P  W      W
W    W WWWWWW WW WWWWW
W WWWW W         W   W
W        WWW WWW   W W
WWWWWWWWWW    WWWWWW W
WG         WW        W
WWWWWWWWWWWWWWWWWWWWWW