WWWWWWWWWWWWWWWWWWWWWW
W WW        W W2     W
W    WWWWWW W W WWWW W
WWWW W     P  W      W
W    W WWWWWW WW WWWWW
W WWWW W         W   W
W        WWW WWW   W W
W WWWWWWWW    WWWWWW W
W1         WW        W
WWWWWWWWWWWWWWWWWWWWWW